###############
#FFF#FFF#FFF###
#FFF#FFF#FFFDS#
#FFF#FFF#FFF#S#
###D###D#FFF#S#
###SSSSS#FFF#S#
####D##S####SSS
###FFF#SSSSSS#S
###FFF#######SS
###FFF#FFFFF#S#
#######FFFFF#S#
#######FFFFFDS#
#######FFFFF###
#######FFFFF###
###############
