###############
#######FFF#FFF#
#######FFF#FFF#
#FFF###FFF#FFF#
#FFF##SD#######
#FFF##SS#FFFFF#
#FFF###S#FFFFF#
#FFFDSSS#FFFFF#
####S####FFFFF#
SSSSSSS##FFFFF#
SSSS##D##SSSSSS
SSSS#FFF#SSSSSS
SSSS#FFF#SSSSSS
#####FFF#######
###############
